串親戚	串親戚
親戚	親戚
親戚關係	親戚關係
右戚	右戚
國戚	國戚
國戚皇親	國戚皇親
外戚	外戚
姻戚	姻戚
甯戚	甯戚
干戚	干鏚
憂戚	憂戚
懿戚	懿戚
戚串	戚串
戚黨	戚黨
戚凱羅	戚凱羅
戚友	戚友
戚夫人	戚夫人
戚家軍	戚家軍
戚容	戚容
戚屬	戚屬
戚施	戚施
戚族	戚族
戚舊	戚舊
戚然	戚然
戚繼光	戚繼光
戚誼	戚誼
戚里	戚里
攀親引戚	攀親引戚
朱干玉戚	朱干玉鏚
欣戚	欣戚
炊臼之戚	炊臼之鏚
王公貴戚	王公貴戚
皇親國戚	皇親國戚
籧篨戚施	籧篨戚施
自詒伊戚	自詒伊戚
自貽伊戚	自貽伊戚
貴戚	貴戚
走親戚	走親戚
遠親近戚	遠親近戚
遠房親戚	遠房親戚
鼓盆之戚	鼓盆之戚
休戚	休慼
休戚與共	休慼與共
休戚相關	休慼相關
同休共戚	同休共慼
君子坦蕩蕩小人長戚戚	君子坦蕩蕩小人長慼慼
哀戚	哀慼
心有戚戚	心有慼慼
悲悲戚戚	悲悲慼慼
悲戚	悲慼
慘戚	慘慼
愁戚戚	愁慼慼
戚墅堰	慼墅堰
戚墅堰區	慼墅堰區
戚戚	慼慼
攸戚相關	攸慼相關
薑愈老愈辣	薑愈老愈辣
愈出愈奇	愈出愈奇
愈發	愈發
一并	一併
不并	不併
中西合并	中西合併
五育并重	五育並重
五行并下	五行並下
交并	交併
侵并	侵併
俱收并蓄	俱收並蓄
倍日并行	倍日並行
催并	催併
內外并重	內外並重
公聽并觀	公聽並觀
兼容并包	兼容幷包
兼容并蓄	兼容幷蓄
兼并	兼併
兼并與收購	兼併與收購
兼收并蓄	兼收幷蓄
兼籌并顧	兼籌幷顧
剛柔并濟	剛柔並濟
勢不并立	勢不並立
勢力并行	勢力並行
南山并壽	南山並壽
反亂并	反亂併
合并	合併
合并爲	合併爲
合并在	合併在
合并成	合併成
合并有	合併有
合并案	合併案
合并症	合併症
同心并力	同心並力
吞并	吞併
圖文并茂	圖文並茂
土洋并舉	土洋並舉
聲情并茂	聲情並茂
媒體狂并潮	媒體狂併潮
平頭并進	平頭並進
年德并高	年德並高
并一不二	併一不二
并上	並上
并不	並不
并不會	並不會
并不在	並不在
并不在乎	並不在乎
并不并	併不併
并不是	並不是
并不能	並不能
并與	並與
并且	並且
并世	並世
并世無雙	並世無雙
并爲	併爲
并舉	並舉
并于	並於
并産	併產
并介之人	並介之人
并先	並先
并入	併入
并興	並興
并兼	併兼
并再	並再
并出	並出
并刀	並刀
并列	並列
并到	併到
并力	併力
并包	幷包
并捲機	併捲機
并發	併發
并發動	並發動
并發展	並發展
并發現	並發現
并發症	併發症
并發表	並發表
并叠	併疊
并口	並口
并可	並可
并可以	並可以
并合	併合
并同	並同
并名	併名
并吞	併吞
并吞下	併吞下
并回	並回
并回去	並回去
并回来	並回來
并在	並在
并坐	並坐
并垂不朽	並垂不朽
并處	並處
并頭	並頭
并頭之花	並頭之花
并頭莲	並頭蓮
并存	並存
并存不悖	並存不悖
并存在	並存在
并壽	並壽
并將	並將
并州	幷州
并州剪	幷州剪
并州故鄉	幷州故鄉
并當	並當
并往	並往
并得	並得
并成	併成
并把	並把
并攏	併攏
并排	並排
并排而坐	並排而坐
并無	並無
并無不可	並無不可
并無不當	並無不當
并無此事	並無此事
并日	並日
并日而食	並日而食
并時	並時
并是	並是
并曰入澱	並曰入澱
并有	並有
并未	並未
并條	並條
并案	併案
并案處理	併案處理
并概青雲	並概青雲
并轂	並轂
并没	並沒
并没有	並沒有
并派	並派
并流	並流 併流
并激	並激
并火	併火
并然	並然
并爲	並爲
并用	並用
并由	並由
并禽	並禽
并科	併科
并稱	並稱
并立	並立
并紗	併紗
并綫	併線
并網	併網
并置	並置
并翼齊飛	並翼齊飛
并聯	並聯
并肩	並肩
并肩作戰	並肩作戰
并肩前進	並肩前進
并肩子	併肩子
并肩幹	並肩幹
并肩而行	並肩而行
并能	並能
并能夠	並能夠
并蒂	並蒂
并蒂蓮	並蒂蓮
并行	並行
并行不悖	並行不悖
并行口	並行口
并行程序	並行程序
并行计算	並行計算
并要	並要
并規範	並規範
并論	並論
并請	並請
并購	併購
并購買	併購買
并購案	併購案
并贓拿敗	並贓拿敗
并贓拿賊	併贓拿賊
并贓治罪	併贓治罪
并起	並起
并迹	並跡
并躺	並躺
并躺在	並躺在
并軌	並軌
并輳	並輳
并轡	並轡
并過	並過
并過去	並過去
并過来	並過來
并進	並進
并進去	並進去
并進來	並進來
并迭	並迭
并邀	並邀
并邦	並邦
并鄰	並鄰
并采	並採
并重	並重
并除	併除
并非	並非
并非在	並非在
并非是	並非是
并馬	並馬
并馳	並馳
并驅	並驅
并駕	並駕
并駕齊驅	並駕齊驅
并騖	並騖
并骨	併骨
幺并矢	幺並矢
歸并	歸併
歸并到	歸併到
歸并在	歸併在
忙并	忙併
急并各邦	急並各邦
恩威并施	恩威並施
恩威并濟	恩威並濟
恩威并用	恩威並用
恩威并行	恩威並行
恩威并重	恩威並重
悲喜交并	悲喜交並
情文并茂	情文並茂
打并	打併
携手并肩	攜手並肩
撤并	撤併
數罪并罰	數罪併罰
文情并茂	文情並茂
明并日月	明並日月
暫并列	暫並列
椿萱并茂	椿萱並茂
比并	比並
水陸并進	水陸並進
火并	火併
狂并潮	狂併潮
相并	相併
相提并論	相提並論
眼手并用	眼手並用
福無重受日禍有并來時	福無重受日禍有並來時
簡并	簡併
肩并肩	肩並肩
肯定并例句	肯定並例句
苯并噻吩	苯並噻吩
蓮開并蒂	蓮開並蒂
蜂午并起	蜂午並起
裁并	裁併
購并	購併
購并案	購併案
賄賂并行	賄賂並行
連三并四	連三併四
連鑣并軫	連鑣並軫
逼并	逼併
非合并	非合併
齊名并價	齊名並價
齊頭并進	齊頭並進
齊心并力	齊心併力
齊足并馳	齊足並馳
齐足并驅	齊足並驅
齐驅并駕	齊驅並駕
齐驅并驟	齊驅並驟
龍虎并伏	龍虎並伏
一至于此	一至於此
下于	下於
不下于	不下於
不中于款	不中於款
不樂于	不樂於
不利于	不利於
不同于	不同於
不善于	不善於
不多于	不多於
不安于位	不安於位
不安于室	不安於室
不小于	不小於
不少于	不少於
不屑于	不屑於
不屬于	不屬於
不形于色	不形於色
不止于此	不止於此
不甘于	不甘於
不等于	不等於
不絶于耳	不絕於耳
不至于	不至於
不致于	不致於
不良于行	不良於行
不遜于	不遜於
不限于	不限於
醜于	醜於
專精于	專精於
專美于前	專美於前
且于	且於
業精于勤	業精於勤
業荒于嬉	業荒於嬉
嚴于	嚴於
嚴于律己	嚴於律己
中于	中於
麗于	麗於
乃至于	乃至於
